6 6 6 6 6 6 6 6 6 6 6 6 6 6 6 6 6 6 6
6 0 0 0 0 0 0 0 0 0 0 0 0 0 0 0 0 0 6
6 5 1 1 1 5 1 5 1 5 1 1 1 5 1 1 1 5 6
6 2 6 6 6 2 6 2 6 2 6 6 6 2 6 6 6 2 6
6 3 6 6 6 3 6 3 6 3 6 6 6 3 6 6 6 3 6
6 4 0 0 0 4 6 3 6 4 0 0 0 4 0 0 0 4 6
6 5 1 5 1 5 6 3 6 5 1 5 1 5 1 1 1 5 6
6 6 6 2 6 2 0 4 0 2 6 2 6 2 6 6 6 2 6
6 6 6 3 6 5 1 5 1 5 6 3 6 3 6 6 6 3 6
6 0 0 4 0 2 6 6 6 2 6 3 6 4 0 0 0 4 6
6 5 1 5 1 5 6 6 6 3 6 3 6 5 1 5 1 5 6
6 2 6 2 6 2 0 0 0 4 0 4 0 2 6 2 6 6 6
6 3 6 3 6 5 1 1 1 5 1 5 1 5 6 3 6 6 6
6 3 6 3 6 2 6 6 6 2 6 6 6 2 0 4 0 0 6
6 3 6 3 6 3 6 6 6 3 6 6 6 5 1 5 1 5 6
6 4 0 4 0 4 0 0 0 4 0 0 0 2 6 2 6 2 6 
6 5 1 5 1 5 1 1 1 5 1 1 1 5 6 3 6 3 6
6 2 6 6 6 2 6 6 6 2 6 6 6 2 6 3 6 3 6
6 3 6 6 6 3 6 6 6 3 6 6 6 3 6 3 6 3 6
6 4 0 0 0 4 0 0 0 4 0 0 0 4 0 4 0 4 6
6 1 1 1 1 1 1 1 1 1 1 1 1 1 1 1 1 1 6
6 6 6 6 6 6 6 6 6 6 6 6 6 6 6 6 6 6 6